Departamento,Municipio,PN,PINU-SD,DC,PL,UD,Total Marcas
ATLANTIDA,LA CEIBA,123718,12575,11850,79478,9203,236824
ATLANTIDA,EL PORVENIR,12292,2033,586,10321,591,25823
ATLANTIDA,ESPARTA,12401,549,199,12820,546,26515
ATLANTIDA,JUTIAPA,20265,877,313,14719,1314,37488
ATLANTIDA,LA MASICA,25637,990,748,17392,1780,46547
ATLANTIDA,SAN FRANCISCO,10696,465,396,9613,960,22130
ATLANTIDA,TELA,55482,3342,7603,28981,3203,98611
ATLANTIDA,ARIZONA,16630,666,565,14670,1116,33647
COLON,TRUJILLO,16404,1253,769,13589,888,32903
COLON,BALFATE,2792,112,532,1719,211,5366
COLON,IRIONA,4319,151,91,3438,404,8403
COLON,LIMON,2136,260,84,1695,161,4336
COLON,SABA,9990,255,188,7865,306,18604
COLON,SANTA FE,1314,135,101,1767,88,3405
COLON,SANTA ROSA AGUAN,2636,99,50,1561,82,4428
COLON,SONAGUERA,14164,391,443,8489,694,24181
COLON,TOCOA,24034,804,425,21719,1802,48784
COLON,BONITO ORIENTAL,8819,1301,117,5994,711,16942
COMAYAGUA,COMAYAGUA,63935,4238,4795,38127,7958,119053
COMAYAGUA,AJUTERIQUE,10864,261,229,6168,819,18341
COMAYAGUA,EL ROSARIO,17140,886,609,9418,524,28577
COMAYAGUA,ESQUIAS,7261,418,506,3498,264,11947
COMAYAGUA,HUMUYA,1686,49,87,1051,124,2997
COMAYAGUA,LA LIBERTAD,12403,593,458,6745,601,20800
COMAYAGUA,LAMANI,3734,101,68,2357,181,6441
COMAYAGUA,LA TRINIDAD,3501,250,191,3120,138,7200
COMAYAGUA,LEJAMANI,7761,210,76,3576,854,12477
COMAYAGUA,MEAMBAR,6923,257,94,4510,202,11986
COMAYAGUA,MINAS DE ORO,5861,287,94,6664,236,13142
COMAYAGUA,OJOS DE AGUA,5435,175,117,6934,319,12980
COMAYAGUA,SAN JERONIMO,13871,490,512,7128,282,22283
COMAYAGUA,SAN JOSE DE COMAYAGUA,4408,356,242,5150,339,10495
COMAYAGUA,SAN JOSE DEL POTRERO,1511,131,65,4361,499,6567
COMAYAGUA,SAN LUIS,4030,191,411,3782,409,8823
COMAYAGUA,SAN SEBASTIAN,3756,59,80,506,71,4472
COMAYAGUA,SIGUATEPEQUE,50581,11277,2524,32742,2213,99337
COMAYAGUA,VILLA DE SAN ANTONIO,9665,513,393,7309,821,18701
COMAYAGUA,LAS LAJAS,5364,228,119,3640,321,9672
COMAYAGUA,TAULABE,13684,580,327,11164,471,26226
COPAN,SANTA ROSA DE COPAN,26520,4265,1405,19636,1258,53084
COPAN,CABAÑAS,9035,380,105,11202,189,20911
COPAN,CONCEPCION,4657,308,68,2357,195,7585
COPAN,COPAN RUINAS,32466,1370,370,17753,609,52568
COPAN,CORQUIN,11006,375,115,3467,91,15054
COPAN,CUCUYAGUA,11043,399,107,10211,349,22109
COPAN,DOLORES,3521,186,106,2738,65,6616
COPAN,DULCE NOMBRE,4151,288,77,3662,344,8522
COPAN,EL PARAISO,54050,650,122,2703,512,58037
COPAN,FLORIDA,12890,1963,696,15138,816,31503
COPAN,LA JIGUA,5098,233,207,2638,291,8467
COPAN,LA UNION,7531,376,105,4099,176,12287
COPAN,NUEVA ARCADIA,18706,773,2073,13285,471,35308
COPAN,SAN AGUSTIN,5706,327,44,2576,113,8766
COPAN,SAN ANTONIO,8271,345,270,4805,797,14488
COPAN,SAN JERONIMO,3991,148,156,6011,184,10490
COPAN,SAN JOSE,8086,343,201,6236,258,15124
COPAN,SAN JUAN DE OPOA,8168,425,131,3556,177,12457
COPAN,SAN NICOLAS,6717,301,197,5574,413,13202
COPAN,SAN PEDRO,3180,204,70,3172,142,6768
COPAN,SANTA RITA,10395,471,774,9147,610,21397
COPAN,TRINIDAD,7947,300,636,3378,137,12398
COPAN,VERACRUZ,2041,158,64,1673,80,4016
CORTES,SAN PEDRO SULA,1024142,136822,105310,580198,105732,1952204
CORTES,CHOLOMA,204870,27176,24751,141569,21236,419602
CORTES,OMOA,97144,5619,6138,32812,3655,145368
CORTES,PIMIENTA,45401,1691,1643,11390,1095,61220
CORTES,POTRERILLOS,43327,1615,1874,31872,1702,80390
CORTES,PUERTO CORTES,222344,17550,21625,182195,17628,461342
CORTES,SAN ANTONIO DE CORTES,34839,1480,1942,17150,1292,56703
CORTES,SAN FRANCISCO DE YOJOA,31299,2368,1717,18952,2104,56440
CORTES,SAN MANUEL,36450,5118,3593,33107,4078,82346
CORTES,SANTA CRUZ DE YOJOA,106330,4525,4834,61750,4738,182177
CORTES,VILLANUEVA,148424,10587,8174,80579,10532,258296
CORTES,LA LIMA,83995,20204,17470,76396,13791,211856
CHOLUTECA,CHOLUTECA,121460,16899,17937,93964,0,250260
CHOLUTECA,APACILAGUA,12902,728,497,10044,0,24171
CHOLUTECA,CONCEPCION DE MARIA,29428,1787,977,13791,0,45983
CHOLUTECA,DUYURE,6013,253,352,1850,0,8468
CHOLUTECA,EL CORPUS,20793,1528,977,11691,0,34989
CHOLUTECA,EL TRIUNFO,44157,3206,2603,26922,0,76888
CHOLUTECA,MARCOVIA,22431,5359,3886,33172,0,64848
CHOLUTECA,MOROLICA,7538,224,763,5849,0,14374
CHOLUTECA,NAMASIGUE,26218,2151,2240,28846,0,59455
CHOLUTECA,OROCUINA,18475,1069,706,12491,0,32741
CHOLUTECA,PESPIRE,15774,869,1510,11164,0,29317
CHOLUTECA,SAN ANTONIO DE FLORES,10537,398,313,6584,0,17832
CHOLUTECA,SAN ISIDRO,6863,247,108,5580,0,12798
CHOLUTECA,SAN JOSE,4278,242,400,2823,0,7743
CHOLUTECA,SAN MARCOS DE COLON,32923,1669,1529,20148,0,56269
CHOLUTECA,SANTA ANA DE YUSGUARE,15566,1133,845,12171,0,29715
EL PARAISO,YUSCARAN,11343,489,592,6610,346,19380
EL PARAISO,ALAUCA,10068,302,303,5898,181,16752
EL PARAISO,DANLI,87396,7178,4464,54355,3781,157174
EL PARAISO,EL PARAISO,28410,1497,1058,17314,1769,50048
EL PARAISO,GUINOPE,8168,364,491,5466,390,14879
EL PARAISO,JACALEAPA,5946,225,272,4348,284,11075
EL PARAISO,LIURE,7028,380,403,6687,354,14852
EL PARAISO,MOROCELI,9890,534,284,8248,441,19397
EL PARAISO,OROPOLI,8514,510,493,3082,540,13139
EL PARAISO,POTRERILLOS,2079,84,105,1525,62,3855
EL PARAISO,SAN ANTONIO DE FLORES,6752,210,136,3049,197,10344
EL PARAISO,SAN LUCAS,6150,224,193,6027,189,12783
EL PARAISO,SAN MATIAS,4667,166,61,3115,108,8117
EL PARAISO,SOLEDAD,3916,374,298,6132,593,11313
EL PARAISO,TEUPASENTI,28355,1139,864,19049,573,49980
EL PARAISO,TEXIGUAT,4565,247,311,6225,288,11636
EL PARAISO,VADO ANCHO,3071,172,41,2151,139,5574
EL PARAISO,YAUYUPE,1451,175,107,2118,100,3951
EL PARAISO,TROJES,26735,848,1148,12139,682,41552
FRANCISCO MORAZAN,DISTRITO CENTRAL,2622275,541022,359204,1143257,311675,4977433
FRANCISCO MORAZAN,ALUBAREN,16789,619,710,8914,612,27644
FRANCISCO MORAZAN,CEDROS,51882,2673,1256,27661,2531,86003
FRANCISCO MORAZAN,CURAREN,51592,1694,680,23398,2604,79968
FRANCISCO MORAZAN,EL PORVENIR,58075,1639,1257,20825,6177,87973
FRANCISCO MORAZAN,GUAIMACA,71039,2934,2389,26986,2609,105957
FRANCISCO MORAZAN,LA LIBERTAD,16345,971,1545,10007,980,29848
FRANCISCO MORAZAN,LA VENTA,13114,569,1366,6207,783,22039
FRANCISCO MORAZAN,LEPATERIQUE,29794,2657,1104,20971,1977,56503
FRANCISCO MORAZAN,MARAITA,28890,2612,738,11215,1876,45331
FRANCISCO MORAZAN,MARALE,14290,944,305,7129,1671,24339
FRANCISCO MORAZAN,NUEVA ARMENIA,6436,949,914,6495,1702,16496
FRANCISCO MORAZAN,OJOJONA,26181,1656,1947,25088,1713,56585
FRANCISCO MORAZAN,ORICA,33473,877,790,16464,2437,54041
FRANCISCO MORAZAN,REITOCA,26115,1062,422,22260,762,50621
FRANCISCO MORAZAN,SABANAGRANDE,35732,3442,1916,35655,2641,79386
FRANCISCO MORAZAN,SAN ANTONIO DE ORIENTE,22585,2770,1868,16455,2153,45831
FRANCISCO MORAZAN,SAN BUENAVENTURA,11134,586,261,4854,594,17429
FRANCISCO MORAZAN,SAN IGNACIO,35142,1051,1530,27669,2129,67521
FRANCISCO MORAZAN,SAN JUAN DE FLORES,28960,1846,1236,26557,3627,62226
FRANCISCO MORAZAN,SAN MIGUELITO,10831,423,353,4438,296,16341
FRANCISCO MORAZAN,SANTA ANA,23395,2689,2155,18209,3954,50402
FRANCISCO MORAZAN,SANTA LUCIA,34021,6133,2775,10531,2081,55541
FRANCISCO MORAZAN,TALANGA,92111,3444,3713,61929,3767,164964
FRANCISCO MORAZAN,TATUMBLA,16244,1466,1047,12376,1755,32888
FRANCISCO MORAZAN,VALLE DE ANGELES,29074,5693,8715,18266,2973,64721
FRANCISCO MORAZAN,VILLA SAN FRANCISCO,27495,1556,1476,18899,3114,52540
FRANCISCO MORAZAN,VALLECILLOS,15385,965,2064,13963,1009,33386
GRACIAS A DIOS,PUERTO LEMPIRA,3672,0,11,2653,56,6392
GRACIAS A DIOS,BRUS LAGUNA,1324,0,3,777,23,2127
GRACIAS A DIOS,AHUAS,1052,0,3,535,7,1597
GRACIAS A DIOS,JUAN FRANCISCO BULNES,630,0,9,314,9,962
GRACIAS A DIOS,VILLEDA MORALES,786,0,5,833,17,1641
GRACIAS A DIOS,WAMPUSIRPI,558,0,5,525,4,1092
INTIBUCA,LA ESPERANZA,5357,221,138,3172,125,9013
INTIBUCA,CAMASCA,2509,136,53,1385,71,4154
INTIBUCA,COLOMONCAGUA,5874,213,43,586,89,6805
INTIBUCA,CONCEPCION,2933,111,15,1606,46,4711
INTIBUCA,DOLORES,2014,140,6,1584,61,3805
INTIBUCA,INTIBUCA,17688,653,234,6289,319,25183
INTIBUCA,JESUS DE OTORO,6788,298,91,2895,165,10237
INTIBUCA,MAGDALENA,1830,110,20,449,21,2430
INTIBUCA,MASAGUARA,4133,258,32,2837,116,7376
INTIBUCA,SAN ANTONIO,2016,148,13,1206,42,3425
INTIBUCA,SAN ISIDRO,1316,27,0,624,23,1990
INTIBUCA,SAN JUAN,4286,225,128,3096,123,7858
INTIBUCA,SAN MARCOS SIERRA,3460,248,84,442,16,4250
INTIBUCA,SAN MIGUELITO,2264,157,19,1753,63,4256
INTIBUCA,SANTA LUCIA,1648,79,21,708,46,2502
INTIBUCA,YAMARANGUILA,5682,247,33,2250,122,8334
INTIBUCA,SAN FRANCISCO DE OPALACA,2062,181,30,917,119,3309
ISLAS DE LA BAHIA,ROATAN,2892,77,86,1437,1177,5669
ISLAS DE LA BAHIA,GUANAJA,900,4,3,302,31,1240
ISLAS DE LA BAHIA,JOSE SANTOS GUARDIOLA,1154,23,16,769,178,2140
ISLAS DE LA BAHIA,UTILA,369,5,6,492,7,879
LA PAZ,LA PAZ,9149,472,1860,7358,1722,20561
LA PAZ,AGUANQUETERIQUE,2010,69,37,1146,187,3449
LA PAZ,CABAÑAS,970,102,23,259,62,1416
LA PAZ,CANE,759,40,58,2116,151,3124
LA PAZ,CHINACLA,2251,114,19,1382,88,3854
LA PAZ,GUAJIQUIRO,4848,305,22,2359,97,7631
LA PAZ,LAUTERIQUE,902,57,17,2176,77,3229
LA PAZ,MARCALA,9160,609,82,3953,555,14359
LA PAZ,MERCEDES DE ORIENTE,255,11,32,349,42,689
LA PAZ,OPATORO,2279,121,23,2154,97,4674
LA PAZ,SAN ANTONIO DEL NORTE,1309,35,10,335,33,1722
LA PAZ,SAN JOSE,2699,170,75,947,53,3944
LA PAZ,SAN JUAN,812,39,76,633,63,1623
LA PAZ,SAN PEDRO DE TUTULE,2756,151,124,1267,159,4457
LA PAZ,SANTA ANA,3090,301,42,1441,113,4987
LA PAZ,SANTA ELENA,1940,171,22,993,163,3289
LA PAZ,SANTA MARIA,3821,241,95,2632,117,6906
LA PAZ,SANTIAGO DE PURINGLA,5605,231,231,3358,108,9533
LA PAZ,YARULA,3316,207,14,1347,53,4937
LEMPIRA,GRACIAS,34772,1704,774,16132,1850,55232
LEMPIRA,BELEN,4781,189,41,3776,543,9330
LEMPIRA,CANDELARIA,4408,153,123,4391,344,9419
LEMPIRA,COLOLACA,5161,286,39,709,520,6715
LEMPIRA,ERANDIQUE,11466,370,57,9805,587,22285
LEMPIRA,GUALCINCE,5658,258,291,1807,401,8415
LEMPIRA,GUARITA,6406,408,27,1105,201,8147
LEMPIRA,LA CAMPA,4931,172,108,2370,579,8160
LEMPIRA,LA IGUALA,17015,719,106,6773,1446,26059
LEMPIRA,LAS FLORES,9106,279,67,3231,353,13036
LEMPIRA,LA UNION,8923,393,126,7429,608,17479
LEMPIRA,LA VIRTUD,5288,182,37,3939,383,9829
LEMPIRA,LEPAERA,22422,1069,924,7229,1099,32743
LEMPIRA,MAPULACA,3285,198,27,2104,146,5760
LEMPIRA,PIRAERA,7121,300,49,5052,818,13340
LEMPIRA,SAN ANDRES,9509,341,39,4882,512,15283
LEMPIRA,SAN FRANCISCO,4937,80,40,2891,382,8330
LEMPIRA,SAN JUAN GUARITA,2151,215,33,865,153,3417
LEMPIRA,SAN MANUEL COLOHETE,8317,315,27,6488,825,15972
LEMPIRA,SAN RAFAEL,8738,323,159,4014,377,13611
LEMPIRA,SAN SEBASTIAN,8163,384,93,2795,704,12139
LEMPIRA,SANTA CRUZ,5228,221,66,2415,492,8422
LEMPIRA,TALGUA,5396,182,70,1737,283,7668
LEMPIRA,TAMBLA,1159,319,37,495,134,2144
LEMPIRA,TOMALA,3026,183,32,3727,186,7154
LEMPIRA,VALLADOLID,2878,175,37,1885,292,5267
LEMPIRA,VIRGINIA,1340,51,41,1615,220,3267
LEMPIRA,SAN MARCOS DE CAIQUIN,2815,160,91,2293,416,5775
OCOTEPEQUE,OCOTEPEQUE,4535,167,119,3756,0,8577
OCOTEPEQUE,BELEN GUALCHO,3814,165,14,2512,0,6505
OCOTEPEQUE,CONCEPCION,939,56,48,874,0,1917
OCOTEPEQUE,DOLORES MERENDON,743,69,17,748,0,1577
OCOTEPEQUE,FRATERNIDAD,571,62,14,360,0,1007
OCOTEPEQUE,LA ENCARNACION,1692,91,17,1110,0,2910
OCOTEPEQUE,LA LABOR,1322,88,37,1396,0,2843
OCOTEPEQUE,LUCERNA,1112,73,12,831,0,2028
OCOTEPEQUE,MERCEDES,1371,125,30,794,0,2320
OCOTEPEQUE,SAN FERNANDO,1373,100,11,1298,0,2782
OCOTEPEQUE,SAN FRANCISCO DEL VALLE,1608,54,16,1114,0,2792
OCOTEPEQUE,SAN JORGE,1232,73,61,804,0,2170
OCOTEPEQUE,SAN MARCOS,3783,139,46,2714,0,6682
OCOTEPEQUE,SANTA FE,964,52,165,857,0,2038
OCOTEPEQUE,SENSENTI,2151,174,77,1257,0,3659
OCOTEPEQUE,SINUAPA,1378,63,21,1506,0,2968
OLANCHO,JUTICALPA,74072,10412,8971,37143,2911,133509
OLANCHO,CAMPAMENTO,18439,2042,866,6740,767,28854
OLANCHO,CATACAMAS,45584,1844,1849,20027,6733,76037
OLANCHO,CONCORDIA,9430,632,396,4562,398,15418
OLANCHO,DULCE NOMBRE DE CULMI,14702,620,739,5573,788,22422
OLANCHO,EL ROSARIO,4184,336,846,3874,119,9359
OLANCHO,ESQUIPULAS DEL NORTE,4629,364,227,3346,176,8742
OLANCHO,GUALACO,11304,369,525,8068,295,20561
OLANCHO,GUARIZAMA,7274,309,325,4120,204,12232
OLANCHO,GUATA,10638,545,1190,5356,212,17941
OLANCHO,GUAYAPE,6643,250,452,3044,457,10846
OLANCHO,JANO,4938,343,565,2425,154,8425
OLANCHO,LA UNION,4863,409,968,4346,1190,11776
OLANCHO,MANGULILE,6449,298,211,5567,238,12763
OLANCHO,MANTO,8056,811,327,5116,215,14525
OLANCHO,SALAMA,6162,362,495,3600,346,10965
OLANCHO,SAN ESTEBAN,8010,303,1376,5433,145,15267
OLANCHO,SAN FRANCISCO DE BECERRA,8306,580,371,7574,212,17043
OLANCHO,SAN FRANCISCO DE LA PAZ,11595,890,730,8203,404,21822
OLANCHO,SANTA MARIA DEL REAL,9112,311,695,4077,589,14784
OLANCHO,SILCA,3665,291,1012,5008,160,10136
OLANCHO,YOCON,5400,384,1487,6514,303,14088
OLANCHO,PATUCA,12912,1109,2729,7497,631,24878
SANTA BARBARA,SANTA BARBARA,46335,2462,4635,30387,2545,86364
SANTA BARBARA,ARADA,15173,443,479,13517,1441,31053
SANTA BARBARA,ATIMA,19390,542,542,12948,958,34380
SANTA BARBARA,AZACUALPA,17259,432,431,2413,340,20875
SANTA BARBARA,CEGUACA,8510,1143,190,5584,485,15912
SANTA BARBARA,SAN JOSE DE COLINAS,16449,577,662,13576,1589,32853
SANTA BARBARA,CONCEPCION DEL NORTE,13204,507,1436,9228,414,24789
SANTA BARBARA,CONCEPCION DEL SUR,7856,245,199,11010,1120,20430
SANTA BARBARA,CHINDA,5109,144,78,4909,154,10394
SANTA BARBARA,EL NISPERO,14511,363,638,11872,747,28131
SANTA BARBARA,GUALALA,2628,71,346,4664,101,7810
SANTA BARBARA,ILAMA,8092,286,930,3110,246,12664
SANTA BARBARA,MACUELIZO,26173,893,1187,8772,1570,38595
SANTA BARBARA,NARANJITO,12357,522,1227,6451,441,20998
SANTA BARBARA,NUEVO CELILAC,6530,210,217,6768,388,14113
SANTA BARBARA,PETOA,14915,365,258,6649,269,22456
SANTA BARBARA,PROTECCION,10712,360,295,3340,841,15548
SANTA BARBARA,QUIMISTAN,28455,1183,3492,8256,1056,42442
SANTA BARBARA,SAN FRANCISCO DE OJUERA,10238,311,113,5568,321,16551
SANTA BARBARA,SAN LUIS,28536,983,618,20178,1176,51491
SANTA BARBARA,SAN MARCOS,9916,412,221,6144,623,17316
SANTA BARBARA,SAN NICOLAS,10560,315,333,6263,786,18257
SANTA BARBARA,SAN PEDRO DE ZACAPA,16242,353,549,18861,733,36738
SANTA BARBARA,SANTA RITA,3136,174,192,2908,182,6592
SANTA BARBARA,SAN VICENTE CENTENARIO,5018,157,88,3791,305,9359
SANTA BARBARA,TRINIDAD,13963,1053,352,12362,494,28224
SANTA BARBARA,LAS VEGAS,26619,2866,543,11415,5093,46536
SANTA BARBARA,NUEVA FRONTERA,11190,339,662,9361,1544,23096
VALLE,NACAOME,18957,725,832,18948,965,40427
VALLE,ALIANZA,4214,88,26,3233,91,7652
VALLE,AMAPALA,4963,444,126,5388,341,11262
VALLE,ARAMECINA,4111,84,7,2992,81,7275
VALLE,CARIDAD,2815,55,13,1299,61,4243
VALLE,GOASCORAN,7147,142,77,5750,158,13274
VALLE,LANGUE,11224,360,49,6550,532,18715
VALLE,SAN FRANCISCO DE CORAY,6223,163,18,5089,197,11690
VALLE,SAN LORENZO,17523,1271,712,15123,673,35302
YORO,YORO,43931,1540,1985,25499,3365,76320
YORO,ARENAL,10220,409,136,5493,346,16604
YORO,EL NEGRITO,26393,881,3133,8825,984,40216
YORO,EL PROGRESO,86355,12168,17678,107236,13059,236496
YORO,JOCON,13810,459,477,15476,509,30731
YORO,MORAZAN,30655,697,977,17902,1456,51687
YORO,OLANCHITO,52632,1581,1791,37365,3756,97125
YORO,SANTA RITA,11678,3814,1431,13649,1297,31869
YORO,SULACO,12699,500,96,12332,9994,35621
YORO,VICTORIA,20210,667,241,15018,839,36975
YORO,YORITO,15155,485,1016,12711,776,30143
